11111111111111111111
12210222222222211201
10010000000000011001
10010001111111011001
10010001111111011001
10000000001110000001
10000000000000000001
10000000011100000001
10001110012100010001
10000000012100010001
10000000011100000001
11111100000000000001
10000000000000111111
10000000000000000001
10000002220000000003
10000002120010000003
10000002220010000001
10000000000010000001
12221122222212222221
11111111111111111111
