11111111111111111111
12211222222222211201
10000000000000011001
10000001111111011001
10000001111111011001
10000000000000000001
10000000000000000001
10000000000000000003
10000000000000000003
10000000000111111111
10000000000111111111
12222222222222222221
12222222222222222221
12222222222222222221
12222222222222222221
12222222222222222221
12222222222222222221
12222222222222222221
12221122222211222221
11111111111111111111

