11111111111111111111
10000000000000000001
10000222222222222001
10000002222222222001
10000000000000002001
10000000000000000001
12222222222000000001
12222222222000000001
10000000000000000001
10000000000000000001
10000000111111111111
10000000111111111111
10000000000000000001
10000000000000000001
11111111111100000001
11111111111100000001
10000000000000000001
10000002222222222221
10000000000000000003
11111111111111111111

