11111111111111111111
10001000100010000001
10100010001000100001
11111111111111100001
10000000000000000001
10000000000000000001
10000000000000000001
10000011100000000001
10000012100000000001
10000011100000000001
10000000000000000001
10000000000000000001
10000000000000000001
10000000000000000001
12222220000000000001
12222220000000000001
10000000022222222222
10000000022222222222
10000000000000000003
11111111111111122222