11111111111111111111
10000000000000000001
10222222222222222201
10000000000000000001
10222222222222222201
10000000000000000001
10222222222222222201
10000000000000000001
10222222222222222201
10000000000000000001
10222222200000000001
10000000000000000001
10222222222222222201
10000000000000000001
10222222222222222201
10000000000000000001
10222222222222222201
10000000000000000001
10000000000000000001
11111111111111111111